NO textures/matrix.xpm
SO textures/matrix.xpm
WE textures/matrix.xpm
EA textures/matrix.xpm

F 231,215,190
C 135,206,235

11111111
10000W01
10111101
101  101
10111101
10000001
11111111
